acruise = Alex Cruise <alex@cluonflux.com>
buraq = buraq <buraq@epfl.ch>
chrisJames = chrisJames <chrisJames@epfl.ch>
cremet = cremet <cremet@epfl.ch>
cunei = Antonio Cunei <antonio.cunei@epfl.ch>
dcaoyuan = dcaoyuan <dcaoyuan@epfl.ch>
dchenbecker = Derek Chen-Beker <dchenbecker@gmail.com>
dpp = David Pollak <feeder.of.the.bears@gmail.com>
dragos = Iulian Dragos <jaguarul@gmail.com>
DRMacIver = David MacIver <david.maciver@gmail.com>
dubochet = Gilles Dubochet <gilles.dubochet@epfl.ch>
emir = Burak Emir <emir@epfl.ch>
eugenevigdorchik = Eugene Vigdorchik <eugenevigdorchik@epfl.ch>
extempore = Paul Phillips <paulp@improving.org>
fsalvi = Fabien Salvi <fabien.salvi@epfl.ch>
grek = Grzegorz Kossakowski <grzegorz.kossakowski@gmail.com>
heathermiller = Heather Miller <heather.miller@epfl.ch>
ilyas = ilyas <ilyas@epfl.ch>
imaier = Ingo Maier <ingo.maier@epfl.ch>
jeberle = jeberle <jeberle@epfl.ch>
Joshua.Suereth = Josh Suereth <joshua.suereth@gmail.com>
jvaucher = NAME <USER@epfl.ch>
kzys = Kato Kazuyoshi <kato.kazuyoshi@gmail.com>
lesani = lesani <lesani@epfl.ch>
lorch = lorch <lorch@epfl.ch>
magarcia = Miguel Garcia <magarcia@epfl.ch>
maier = NAME <USER@epfl.ch>
malayeri = Donna Malayeri <lindydonna@gmail.com>
mcdirmid = Sean McDirmid <sean.mcdirmid@gmail.com>
michelou = michelou <michelou@epfl.ch>
mihaylov = mihaylov <mihaylov@epfl.ch>
milessabin = Miles Sabin <miles@milessabin.com>
moez = moez <moez@epfl.ch>
moix = moix <moix@epfl.ch>
moors = Adriaan Moors <adriaan.moors@epfl.ch>
nielsen = nielsen <nielsen@epfl.ch>
noir = noir <noir@epfl.ch>
odersky = Martin Odersky <odersky@gmail.com>
paltherr = paltherr <paltherr@epfl.ch>
pedrofurla = Pedro Furlanetto <pedrofurla@gmail.com>
phaller = Philipp Haller <hallerp@gmail.com>
plocinic = Hubert Plociniczak <hubert.plociniczak@epfl.ch>
pradel = pradel <pradel@epfl.ch>
prokopec = Aleksandar Pokopec <aleksandar.prokopec@epfl.ch>
rompf = Tiark Rompf <tiark.rompf@epfl.ch>
rytz = Lukas Rytz <lukas.rytz@epfl.ch>
sbucher = sbucher <sbucher@epfl.ch>
schinz = schinz <schinz@epfl.ch>
shack = shack <shack@epfl.ch>
spoon = Lex Spoon <lex@lexspoon.org>
stenman = stenman <stenman@epfl.ch>
stepancheg = stepancheg <stepancheg@epfl.ch>
ureche = Vlad Ureche <vlad.ureche@epfl.ch>
vjovanov = Vojin Jovanovic <vojin.jovanovic@epfl.ch>
washburn = Geoffrey Washburn < geoffrey.washburn@epfl.ch>
zenger = Matthias Zenger <mzenger@gmail.com>
(no author) = Automation Bot <noreply@epfl.ch>
thhofer = thofer <thofer@epfl.ch>
tvcutsem = tvcutsem <tvcutsem@epfl.ch>
marmori = marmori <marmori@epfl.ch>
joaquim = joaquim <joaquim@epfl.ch>
lavanchy = lavanchy <lavanchy@eplf.ch>
copponne = copponne <copponne@epfl.ch>
manojo = manojo <manojo@epfl.ch>
hosekp = hosekp <hosekp@epfl.ch>
Mirco = Micro Dotta <mirco.dotta@gmail.com>
skyluc = skyluc <skyluc@epfl.ch>
